#################
#   # ###  # #  #
# ##  ###       #
#   # #         #
E #  #  ####    #
##       #  ### #
#### ##  #  ### S
##   #   #     ##
###       #    ##
## ### ## ## #  #
#################
