###################
# # # ## #    #  ##
### ##  #  ## #####
###     #   #   ###
#   #  # #  # # ###
#   ##   #    #####
# # ## ## ##   # ##
######   # # #  ###
# #   #####   #  ##
## # #  ## ##     #
##  ##      #  #  S
E # ### ##   #   ##
#   ##   # #    # #
#       ## #     ##
#  ##     ##     ##
###################
