###################
E ###  #  #### ####
# #####  #######  S
#    # # # ##     #
###         # #   #
## #   ##   # # # #
##  #   #     #   #
#  ##   ##   ######
## #        ##### #
# ## ##   ## ##   #
# # #   # #  ### ##
#  #   ## # #  ## #
##  ### ### #   ###
##  #        ### ##
###  #   # ########
### ##      #######
###################
