##########
##### # ##
##   #####
### # ## #
# ###### #
# #### # #
#### # ###
## ## # ##
##  #  # #
####     #
# ###    S
##      ##
#  ##   ##
#  ## # ##
### #  ###
#     # ##
#      ###
E   ## # #
##########
