#################
##  # #     ##  #
###  #     # ## #
#  ## ### #    ##
#  ## # ## # #  S
# #    # #  #   #
##      ## # #  #
####   #### ### #
##  ###  ## #   #
# ###    # #### #
## ###  ####    #
### #  ###      #
#      #   #### #
#           ##  #
# #    ##       #
E  # ###        #
#####  ##  ##   #
# # ##  ####   ##
#################
