##################
###  ##   ##    ##
## ## ####   ##  #
#  ##  # #### ####
#  #    #####  # #
#####  ####  ##  #
## ######  #  ## #
##     # ##### # S
#  ###  # # # ## #
E ###  # #   #   #
# ### # # ##     #
#   # #        # #
###     # #   ## #
#  ## ####    #  #
#   # ### ###  # #
# ###      #     #
#   ## ## # ##   #
##################
