####################
# #  ###      #    #
##   #  ##  ##  #  #
# ## #     ###    ##
## #  # ## #   #   #
# #  #### # #####  #
# ### # # #  ### ###
#  ##  ### #       #
### ### # # ## # ###
#  # ##  # #  # #  #
E ###     #  ### ###
#  ###   # # # ##  #
#    # #  # ##     #
##  ## #  # ###    S
# #   #  ## #     ##
# #      #   ##   ##
#                 ##
####################
