############
#  #     # #
##  # # ## #
# #   #### #
###  ### # #
#       ####
E ## ####  #
# ##       S
############
