####################
######## ##  # #####
# ## # # ##     ## #
## #  ##### # ##   #
# #  ##    #    # ##
# ##    # ## #### ##
## # #####   # # ###
#  ## ### # #####  #
# #   #       ##   #
## #  # ###       ##
# ####  # #  #     S
####### #          #
#      # #  #      #
E     # ##  #    # #
# # #  #   #   #   #
###      ### ####  #
####################
